- *                  -
-                   *-
-     #      *      --
-     # *#*    # * ##-
-   -&#  -&&---##   0-
----------------------
level
-                    -
-                    -
-   *    # -  #*    *-
-   # * #-  *#  -    -
- # # * - & --&&&#& 0-
----------------------
level
-                    -
-            *     &&-
-            -   * ---
-    #  *#-    -  ** -
-  &##* -&--*&    ##0-
----------------------
level
